*******************************************************
* P                                                   *
*                                                     *
*                                                     *
*                                                     *
*                                                     *
*                                                     *
*                                                     *
*                                                     *
*                                                     *
*                                                     *
*                                                     *
*                                                     *
*                                             E       *
*                                                     *
*******************************************************