*********************************************************************************************************
*  P                                                                                                     *
*         ****               ******      *                                                              *
*        **  **              *           *                                                              *
**********    ****           *************                                                              *
                 *            ***********                        ****************************************
                 *             *********                        *          *                             *
           *******              *******                        *           *                             *
           *                     *****                        *            *                             *
           *                      ***                        *             *                             *
******     *******                 *                                      *             *****************
*     *           ***************    *     ************                  *              *
*     *                         *    *                *                 *               *
*     *****                     *    *               *                 *                *
*         *                     *    *              *                 *                 *
*         *                     *    *             *                 *                  *
*         *                     *    *            *                 *                   *
*         ***********************    *           *                 *                E   *
*                                    *          *                                       *
**   *******                         *         *                            *************
 *      *  *      ************************************                      *
 *      *  *                                          *                     *
 ********  *                ******                     *                    *
           *               ********                     *                   *
           *                                                                *
           ******************************************************************
