***********************************
*                                 *
*   P                             *
*                                 *
*                                 *
***********************           *
                      *           *
                      *           *
                      *    E      *
                      *************