************************************
*                                  *
*     P                            *
*                                  *
*                                  *
*                           E      *
*                                  *
************************************