*******************************************************
* P                                                   *
*                                                     *
*                                                     *
*                                                     *
*                                                     *
*                                                     *
*                                                     *
*                                                     *
*                                      ******         *
*                                      *E             *
*                                      *              *
*                                      *              *
*                                                     *
*                                                     *
*******************************************************