*****************************
*           * E             *
*   P       *               *
*           ***********     *
*                 *   *     *
************      *   *     *
           *      *   *     *
           *      *   *     *
           *      *****     *
           *                *
           *                *
           ******************