*******************************************************
* P          *                                        *
*            *                                        *
*            *                                        *
*            *                                        *
*            *                                        *
*   **********                                        *
*                                                     *
*                                                     *
*                                                     *
*                                                     *
*                                                     *
*                                                     *
*                                             E       *
*                                                     *
*******************************************************